########.########.#######.#######.########.#######
#######...######...#####...#####...######...######
#######...######...#####...#####...######...######
######.....####.....###.....###.....####.....#####
######.....####.....###.....###.....####.....#####
#####.......##.......#.......#.......##.......####
#####.......##.......#.......#.......##.......####
####...........................................###
##..............................................##
##..............................................##
##..............................................##
##..............................................##
##.............................................>##
##..............................................##
##..............................................##
##..............................................##
##################################################
##################################################