##################################################
#######..............########..............#######
####...................####...................####
###.....................##.....................###
##......................(.......................##
##..............................................##
##..............................................##
##..............................................##
###............................................###
####..........................................####
######......................................######
#######....................................#######
#########................................#########
##########..............................##########
############..........................############
##############......................##############
################..................################
###################............###################
#####################........#####################
#######################.>..#######################
##################################################