#############################################
#######............#######............#######
####.................###.................####
###...................#...................###
##.........................................##
##.........................................##
##.........................................##
##.........................................##
###.......................................###
####.....................................####
######.................................######
#######...............................#######
#########...........................#########
##########.........................##########
############.....................############
##############.................##############
################.............################
###################.......###################
#####################...#####################
#############################################
